mol Ph4_features
mol_ID_1_NBLIVFMKDQOTHN-UHFFFAOYSA-N	RAAHH
mol_ID_2_IMRWILPUOVGIMU-UHFFFAOYSA-N	RAH
mol_ID_3_DPZYLEIWHTWHCU-UHFFFAOYSA-N	RAH
mol_ID_4_OKDGRDCXVWSXDC-UHFFFAOYSA-N	RAH
mol_ID_5_GZPHSAQLYPIAIN-UHFFFAOYSA-N	RAA
mol_ID_6_ZLNPDTOTEVIMMY-UHFFFAOYSA-N	RAAH
mol_ID_7_BMNUHRHTDNKJII-UHFFFAOYSA-N	RAAH
mol_ID_8_AXHRGVJWDJDYPO-UHFFFAOYSA-N	RDAH
mol_ID_9_BADSZRMNXWLUKO-UHFFFAOYSA-N	RDAH
mol_ID_10_UXZQDYUBSQMFIE-UHFFFAOYSA-N	RDAH
mol_ID_11_VRIFFHHNSRUZNX-UHFFFAOYSA-N	RAHHH
mol_ID_12_PWRBCZZQRRPXAB-UHFFFAOYSA-N	RAH
mol_ID_13_GPHQHTOMRSGBNZ-UHFFFAOYSA-N	RAA
mol_ID_14_PGFIHORVILKHIA-UHFFFAOYSA-N	RAAH
mol_ID_15_GFVQKBROKWSUNG-UHFFFAOYSA-N	RAAH
mol_ID_16_FHZALEJIENDROK-UHFFFAOYSA-N	RDAH
mol_ID_17_WVGCPEDBFHEHEZ-UHFFFAOYSA-N	RDAH
mol_ID_18_KUOWLAMMSCRRFS-UHFFFAOYSA-N	RDAH
mol_ID_19_RYIHZFZTDJNDGM-UHFFFAOYSA-N	RAHHH
mol_ID_20_PVMNPAUTCMBOMO-UHFFFAOYSA-N	RAH
mol_ID_21_KGIGUEBEKRSTEW-UHFFFAOYSA-N	RAH
mol_ID_22_GYCPLYCTMDTEPU-UHFFFAOYSA-N	RAAH
mol_ID_23_GELVZYOEQVJIRR-UHFFFAOYSA-N	RAAH
mol_ID_24_MHHDMDLNVVCTAJ-UHFFFAOYSA-N	RDAH
mol_ID_25_XHZWFUVEKDDQPF-UHFFFAOYSA-N	RDAH
mol_ID_26_QIXCSHIEHGEJGB-UHFFFAOYSA-N	RAH
mol_ID_27_CLRPXACRDTXENY-UHFFFAOYSA-N	RAH
mol_ID_28_ZIEWSZYVEDTXGH-UHFFFAOYSA-N	RAAA
mol_ID_29_KANZWHBYRHQMKZ-UHFFFAOYSA-N	RAAH
mol_ID_30_AXDGIPMYJALRKV-UHFFFAOYSA-N	RAAH
mol_ID_31_WGFCNCNTGOFBBF-UHFFFAOYSA-N	RAAH
mol_ID_32_BHCMXJKPZOPRNN-UHFFFAOYSA-N	RDAH
mol_ID_33_LLNQWPTUJJYTTE-UHFFFAOYSA-N	RDAH
mol_ID_34_UUAXDPHPSHEGQQ-UHFFFAOYSA-N	RAA
mol_ID_35_BSQLQMLFTHJVKS-UHFFFAOYSA-N	RRAH
mol_ID_36_NYPYPOZNGOXYSU-UHFFFAOYSA-N	RAH
mol_ID_37_KFDVPJUYSDEJTH-UHFFFAOYSA-N	RAH
mol_ID_38_DNWRLMRKDSGSPL-UHFFFAOYSA-N	RAAH
mol_ID_39_OYWPFIUVDKHHGQ-UHFFFAOYSA-N	RAAH
mol_ID_40_QMQZIXCNLUPEIN-UHFFFAOYSA-N	RDAA
mol_ID_41_RUKDVLFJSMVBLV-UHFFFAOYSA-N	RDAH
mol_ID_42_UEEBKQWDBWDPKD-UHFFFAOYSA-N	RAA
mol_ID_43_RXNZFHIEDZEUQM-UHFFFAOYSA-N	RAH
mol_ID_44_BSDGZUDFPKIYQG-UHFFFAOYSA-N	RAH
mol_ID_45_NHUBNHMFXQNNMV-UHFFFAOYSA-N	RAH
mol_ID_46_IIHQNAXFIODVDU-UHFFFAOYSA-N	RAAA
mol_ID_47_PMSVVUSIPKHUMT-UHFFFAOYSA-N	RAAA
mol_ID_48_NWVGXXPWOYZODV-UHFFFAOYSA-N	RDAA
mol_ID_49_NUGZBVBZIDWZAD-UHFFFAOYSA-N	RDAA
mol_ID_50_WGUDVGBIIATHCI-UHFFFAOYSA-N	RPHH
mol_ID_51_DWUPYMSVAPQXMS-UHFFFAOYSA-N	RAH
mol_ID_52_CCZWSTFVHJPCEM-UHFFFAOYSA-N	RAH
mol_ID_53_BQRBAXFOPZRMCU-UHFFFAOYSA-N	RDAH
mol_ID_54_ZNPNOVHKCAAQCG-UHFFFAOYSA-N	RPHH
mol_ID_55_IQMAASXLMDIWRF-UHFFFAOYSA-N	RAH
mol_ID_56_OSSNTDFYBPYIEC-UHFFFAOYSA-N	RAH
mol_ID_57_NWHSSMRWECHZEP-UHFFFAOYSA-N	RAH
mol_ID_58_NQQUGKKTJLAUHC-UHFFFAOYSA-N	RAPH
mol_ID_59_VAQSRTGFMKWNIH-UHFFFAOYSA-N	RAH
mol_ID_60_XDELKSRGBLWMBA-UHFFFAOYSA-N	RAH
mol_ID_61_FDEDJRHULYIJOR-UHFFFAOYSA-N	RAH
mol_ID_62_XVIAPHVAGFEFFN-UHFFFAOYSA-N	RAAA
mol_ID_63_GLEJGPDNIJWWQH-UHFFFAOYSA-N	RAAH
mol_ID_64_MHQZDNQHLGFBRN-UHFFFAOYSA-N	RDAH
mol_ID_65_UMRPGBHVNGOFMG-UHFFFAOYSA-N	RDAH
mol_ID_66_JTJWPHJWCFVTMS-UHFFFAOYSA-N	RAHHH
mol_ID_67_ZIRGWUZHKJDYKT-UHFFFAOYSA-N	RAA
mol_ID_68_RTLUPHDWSUGAOS-UHFFFAOYSA-N	RAH
mol_ID_69_UNCQVRBWJWWJBF-UHFFFAOYSA-N	RAAH
mol_ID_70_ZDHWTWWXCXEGIC-UHFFFAOYSA-N	RAAH
mol_ID_71_OCVXSFKKWXMYPF-UHFFFAOYSA-N	RDAH
mol_ID_72_UGOQKSGJGCADAG-UHFFFAOYSA-N	RAH
mol_ID_73_YPIINMAYDTYYSQ-UHFFFAOYSA-N	RDAH
mol_ID_74_GYHZPSUAMYIFQD-UHFFFAOYSA-N	RAHHH
mol_ID_75_XWXPRCDFFCVMNT-UHFFFAOYSA-N	RAA
mol_ID_76_FFNVQNRYTPFDDP-UHFFFAOYSA-N	RAA
mol_ID_77_DBPKMSBWOKAKLA-UHFFFAOYSA-N	RAAH
mol_ID_78_HXXVIKZQIFTJOQ-UHFFFAOYSA-N	RAAH
mol_ID_79_CGKJVNDEOWHROX-UHFFFAOYSA-N	RPHHH
mol_ID_80_BVUQSVSAXBSDPG-UHFFFAOYSA-N	RPHHH
mol_ID_81_RBANULMALHFXIH-UHFFFAOYSA-N	RPHHH
mol_ID_82_NMNOXVWRJISEFE-UHFFFAOYSA-N	RAHHH
mol_ID_83_JDCUKFVNOWJNBU-UHFFFAOYSA-N	RAH
mol_ID_84_SZMYFESRCUFULU-UHFFFAOYSA-N	RAH
mol_ID_85_CDFUVXUAFYQGMT-UHFFFAOYSA-N	RAH
mol_ID_86_JWFJFVXHZUVMSF-UHFFFAOYSA-N	RAH
mol_ID_87_BBVQDWDBTWSGHQ-UHFFFAOYSA-N	RRAH
mol_ID_89_QCKQICVQNDDMCF-UHFFFAOYSA-N	RAPH
mol_ID_91_BDHWWGOWOGACLG-UHFFFAOYSA-N	RAHH
mol_ID_92_QMZJDMNRLIZTAI-UHFFFAOYSA-N	RRAH
mol_ID_93_YKZVUUJLOGTEQT-UHFFFAOYSA-N	RPHH
mol_ID_94_HETQOWPCHKBEFO-UHFFFAOYSA-N	RPHH
mol_ID_95_ASOWJZPNLMTBRG-UHFFFAOYSA-N	RPHH
mol_ID_96_CMNPLPHOVMUCLQ-UHFFFAOYSA-N	RPHH
mol_ID_97_YPQVJNCIBVIPOK-UHFFFAOYSA-N	RAPH
mol_ID_98_CXFJZYUMQXIIQM-UHFFFAOYSA-N	RAPHH
mol_ID_99_QUHHCIRUCADWJO-UHFFFAOYSA-N	RAPHH
mol_ID_100_ZUHZWFGTRURCNC-UHFFFAOYSA-N	RPHH
mol_ID_101_FFUABMBEXGAHFH-UHFFFAOYSA-N	RAPHH
mol_ID_102_OBLNDKIKUUIFBM-UHFFFAOYSA-N	RAPHH
mol_ID_103_KFAKEMDBMUVYCL-UHFFFAOYSA-N	RAPHH
mol_ID_104_LHTLRZAQHITLCY-UHFFFAOYSA-N	RPHHH
mol_ID_105_KQIINLALKVYVSD-UHFFFAOYSA-N	RPHHH
mol_ID_106_RGGYXESXCZRPIW-UHFFFAOYSA-N	RPHHH
mol_ID_107_FJXDSYCGPUWXNR-UHFFFAOYSA-N	RPHHH
mol_ID_108_DTJIKSRARSRPBU-UHFFFAOYSA-N	RPHH
mol_ID_109_KGRDEPIDYWNXIV-UHFFFAOYSA-N	RAAPH
mol_ID_110_WVZHSQIASVAADH-UHFFFAOYSA-N	RPHH
mol_ID_111_FYOQFGVOCZGIRH-UHFFFAOYSA-N	RPHHH
mol_ID_112_AJWDVSJQPIRAKK-UHFFFAOYSA-N	RPHH
mol_ID_113_MMAPITDUIFJZAW-UHFFFAOYSA-N	RAAPH
mol_ID_114_KTTGUZOLWPMJBL-UHFFFAOYSA-N	RPHH
mol_ID_115_OHWQEFJZXKFNON-UHFFFAOYSA-N	RAPHH
mol_ID_116_MVBDRXROBNCUDL-UHFFFAOYSA-N	RPHH
mol_ID_117_ILLPNUNDXJGWBW-UHFFFAOYSA-N	RAAPH
mol_ID_118_OFIDDJQZAXVXPA-UHFFFAOYSA-N	RAPHH
mol_ID_119_RHXVRVWMOMYZMS-UHFFFAOYSA-N	RPHH
mol_ID_120_WXYZEVYJGPBUNG-UHFFFAOYSA-N	RPHH
mol_ID_121_QZLUCAPHRNBQKI-UHFFFAOYSA-N	RAPHH
mol_ID_122_CNKAQRKQLVLFRP-UHFFFAOYSA-N	RAPHH
mol_ID_123_YGAUGAUSUDDRSL-UHFFFAOYSA-N	RAPHH
mol_ID_124_PVCMMUAMPCOQDW-UHFFFAOYSA-N	RPHHH
mol_ID_125_XMZORIHGFAUARA-UHFFFAOYSA-N	RPHHH
mol_ID_126_REJIEFIUUPPGDW-UHFFFAOYSA-N	RAPHH
mol_ID_127_GCRNFVDWOLZIPL-UHFFFAOYSA-N	RPHHHH
mol_ID_128_VCRLSCAIZHMSMU-UHFFFAOYSA-N	RPHH
mol_ID_129_NBKMUZOBSVVBTA-UHFFFAOYSA-N	RAPH
mol_ID_130_HWVNJCFSKXBPLK-UHFFFAOYSA-N	RPHH
mol_ID_131_SZSSZCNINLAHSY-UHFFFAOYSA-N	RPHHH
mol_ID_132_CJABVDUEGRKDOS-UHFFFAOYSA-N	RAPHH
mol_ID_133_FRGLQFSDULVWTK-UHFFFAOYSA-N	RPHH
mol_ID_134_UHCJSJXZTFABSU-UHFFFAOYSA-N	RAPHH
mol_ID_135_KMIPCBIJDOEGBW-UHFFFAOYSA-N	RAPHH
mol_ID_136_ZSYCSGAWGTXHNT-UHFFFAOYSA-N	RAPHH
mol_ID_137_MGRIYEROULYODG-UHFFFAOYSA-N	RPHHH
mol_ID_138_XUACABVGYOKXQI-UHFFFAOYSA-N	RPHHH
mol_ID_139_KEFUDFMHQALCMK-UHFFFAOYSA-N	RPHH
mol_ID_140_DPKKJSJVHMIUKO-UHFFFAOYSA-N	RAPHH
mol_ID_141_QAUSHIQXFVQJQA-VIFPVBQESA-N	APHHH
mol_ID_142_WTBMMENXWDHRKE-UHFFFAOYSA-N	RPHH
mol_ID_143_XTDXNOKSMWTDMK-UHFFFAOYSA-N	RAPHH
mol_ID_144_BTDXKGYEXJXKNN-UHFFFAOYSA-N	RPHH
mol_ID_145_WYRRTJKOMZONQO-UHFFFAOYSA-N	RRAA
mol_ID_146_SIKJAQJRHWYJAI-UHFFFAOYSA-N	RRD
mol_ID_147_XJEVHMGJSYVQBQ-VIFPVBQESA-N	RDP
mol_ID_148_NCZOVCDTUUZEEA-UHFFFAOYSA-N	RRDAH
mol_ID_151_ODJCIHKBMUREOC-UHFFFAOYSA-N	RDHH
mol_ID_154_XWENGDIACIBQQL-UHFFFAOYSA-N	RDAPH
mol_ID_155_QYBXZYYECZFQRX-UHFFFAOYSA-N	RAAAPN
mol_ID_156_VMLKTERJLVWEJJ-UHFFFAOYSA-N	RRAA
mol_ID_157_YWUNGYFXNDOGNZ-UHFFFAOYSA-N	RDAP
mol_ID_158_JVZRCNQLWOELDU-UHFFFAOYSA-N	RRA
mol_ID_160_NKNQLJMAPSUXLZ-GQCTYLIASA-N	RDDAA
mol_ID_161_CHNZCZASRHSRAC-RXMQYKEDSA-N	AAA
mol_ID_162_SQRSIOZFPSFABI-UHFFFAOYSA-N	RRDAH
mol_ID_164_FLBAYUMRQUHISI-UHFFFAOYSA-N	RRAA
mol_ID_165_YUOYYPWFXYRVHK-UHFFFAOYSA-N	RDAPH
mol_ID_166_MGHPNCMVUAKAIE-UHFFFAOYSA-N	RRDP
mol_ID_168_YRTFBBSKIRZNAW-LURJTMIESA-N	RDAAHH
mol_ID_169_LCALUFNLWHYTKX-UHFFFAOYSA-N	RRAAAN
mol_ID_170_FVBLFJODKIHJMW-UHFFFAOYSA-N	RDAPH
mol_ID_171_CDALGRHRPPTQPM-LLVKDONJSA-N	RDDAA
mol_ID_172_YFNHWMNECPFUGS-UHFFFAOYSA-N	RDAHH
mol_ID_174_CGSWRHKBLLDUHO-UHFFFAOYSA-N	RRDAP
mol_ID_175_XQCLUVVQJMLNAW-UHFFFAOYSA-N	RRDAAHHH
mol_ID_176_CIPVVROJHKLHJI-UHFFFAOYSA-N	RHHH
mol_ID_177_TUVNVZQRVAQHKU-UHFFFAOYSA-N	RAH
mol_ID_178_UWYBOEZQGCFECQ-UHFFFAOYSA-N	RDDAH
mol_ID_181_NUYCSMIPFIJMQL-WCBMZHEXSA-N	RDDP
mol_ID_182_SGKURJURKCHGJG-UHFFFAOYSA-N	RDAHH
mol_ID_184_KTACZRWRTSQVNO-UHFFFAOYSA-N	RDAPP
mol_ID_188_XDFZKQJLNGNJAN-UHFFFAOYSA-N	RRDAH
mol_ID_189_JPYPDSHHTRFKAI-UHFFFAOYSA-N	RRRDAA
mol_ID_193_OCHYJSATRBHPLB-UHFFFAOYSA-N	RDAH
mol_ID_195_UGVAQFVQIHNCJV-UHFFFAOYSA-N	RDAHH
mol_ID_195_SYHYFYSGUQRNRS-UHFFFAOYSA-N	AAHH
mol_ID_197_MNJITFGKRQIUJN-VIFPVBQESA-N	RRDAPH
mol_ID_198_YAKOUCKNNNLXIH-UHFFFAOYSA-N	RAAA
mol_ID_199_OXELIFPFCCGAJX-UHFFFAOYSA-N	RDHH
mol_ID_200_OALXTMWCXNPUKJ-UHFFFAOYSA-N	RDAH
mol_ID_201_RFJQGIYJJLWZJP-UHFFFAOYSA-N	RRDAA
mol_ID_202_MAXMUBIIZUKOJF-UHFFFAOYSA-N	RAA
mol_ID_203_LVGKXNPVUJDONV-UHFFFAOYSA-N	RDAA
mol_ID_204_QHRSESMSOJZMCO-UHFFFAOYSA-N	RRDAH
mol_ID_205_FNXVEILQGNGZNE-UHFFFAOYSA-N	RAAAHH
mol_ID_206_KKJBHMRJVQULAV-UHFFFAOYSA-N	RDAPH
mol_ID_209_HMXUYPBDUYSWMA-UHFFFAOYSA-N	RRAAH
mol_ID_210_CSNJUQMJDHNKHI-UHFFFAOYSA-N	RAA
mol_ID_213_YIZXPHILNOGRDP-UHFFFAOYSA-N	RDAPH
mol_ID_214_BGYVTOPASJGSEB-UHFFFAOYSA-N	RDDAH
mol_ID_215_AKQCTDMGIZKFRX-LURJTMIESA-N	RAANH
mol_ID_217_MQKOIUAPLLHABT-MRVPVSSYSA-N	RDPPH
mol_ID_219_RLTIVBMLQJFUOB-UHFFFAOYSA-N	RDA
mol_ID_220_VNZLQLYBRIOLFZ-UHFFFAOYSA-N	RDAPH
mol_ID_221_RHYBFKMFHLPQPH-UHFFFAOYSA-N	DAAH
mol_ID_222_MPBAFCASVITYMO-UHFFFAOYSA-N	RDAH
mol_ID_223_BDGKBEOKGJRBPL-UHFFFAOYSA-N	RAPHHH
mol_ID_224_ABBIJUYBGHHPFV-UHFFFAOYSA-N	RDAAPHH
mol_ID_225_SRAVSVBVHDLLPO-UHFFFAOYSA-N	RDAPH
mol_ID_226_FKPXGNGUVSHWQQ-UHFFFAOYSA-N	RDAH
mol_ID_227_JWCGDNHAPBZVHD-AOOOYVTPSA-N	RA
mol_ID_228_DOHKJEHZIZZYLD-UHFFFAOYSA-N	RDAPPHH
mol_ID_229_ZDEWVCFSCQUKTE-UHFFFAOYSA-N	RDDP
mol_ID_231_QIBUBNNYBJRUAV-UHFFFAOYSA-N	RAAANH
mol_ID_232_DXWQOYPYNPSVRL-UHFFFAOYSA-N	RAH
mol_ID_233_XZOKPWSKJRCLQO-UHFFFAOYSA-N	RAAHH
mol_ID_234_WATWKPHWUDHKGA-LLVKDONJSA-N	RDPHH
mol_ID_235_WVNMLOGVAVGQIT-UHFFFAOYSA-N	RRAH
mol_ID_236_YLYAETTZHAUHNX-UHFFFAOYSA-N	RDAAP
mol_ID_237_IPYDNTFWMDEOBW-UHFFFAOYSA-N	RDAP
mol_ID_238_VXOJYMHSOARYSV-UHFFFAOYSA-N	RRDAA
mol_ID_240_VNEIHOLJEZRVCL-UHFFFAOYSA-N	RRDDPH
